0000000000000000000000000
0011110001111110111111000
0100010201000001010000000
0102011211020111120100000
0100000000000000000001000
0111111111111111111111000
0000000000000000000001000
0111011111101112111011000
0101010002001000100001000
0101010111111011111011000
0101020100001000010201000
0111111111111111111111000
0000000000000000000000000
0111011111101112111011000
0101010002001000100001000
0101010111111011111011000
0101020100001000010201000
0111111111111111111111000
0000000000000000000000000
0000000000000000000000000