2222222222222222222222222
2000000000100020000000002
2000111100000000111000002
2000011000011100000000202
2000112202000002000000002
2000000000001110002220002
2002200000010000000000002
2000000002220020000011122
2000111000000000000000002
2000000010001112000000002
2000111111000000000022002
2000000000100022000000002
2011110000000000111000002
2000002000011100000000202
2000112002000002000000002
2000000000001110002220002
2002200000010000000000002
2000000002220020000011022
2000000000000000000000002
2222222222222222222222222
